13 30
0 5
0 1
7 20
XOOOXOOOXOOOOOXOOOXXOOXOOOOOXO
XXOOOXOOOXOOOOOXOOXXOXOOOOOXOO
XOXOOOXOOOOOXOOXOOXXXOOOOOXOOO
XOOXOOOXOOOXOXOOOOOOOOOOOOOOOO
OOOOXOOOXOXOOXOXOOOXOOOOOOOOOO
OOOOOOOXXXOOOOOXOOOXOOOXOOOOOO
OOOXXOXXXXXOOOOXOOOXXOOOXOOOOO
OXOOOOOXXXOOOOOOOOOXOXOOOXOOOO
OOXOOOOOXXOOOOOOOOOXOOXOOOOOOO
XOOOOOXOOOOOOOOOOOOXOOOXOOOOOO
XOOOXOOOOOOOXOOOOOXXOXOOXOOOOO
XOOOOOXOOXOOOOOOOOXXOOXOOOOOOO
XOOOOOOOOOOOOOOOOOXXOOOOOOOOOO
