13 20
0 5
0 1
7 16
XOOOXOOOXOOOOOXOOOXX
XXOOOXOOOOOOOOOXOOXX
XOXOOOXOOOOOXOOXOOXX
XOOXOOOXOOOXOXOOOOOO
OOOOXOOOXOXOOXOXOOOX
OOOOOOOXXXOOOOOXOOOX
OOOXXXXXXXXOOOOXOOOX
OXOOOOOXXXOOOOOOOOOX
OOXOOOOOXOOOOOOOOOOX
XOOOOOOOOOOOOOOOOOOO
XOOOXOOOOOOOXOOOOOXX
XOOOOOXOOXOOOOOOOOXX
XOOOOOOOOOOOOOOOOOXX
