13 20
7 16
0 5
0 1
XOOOXOOOXOOOOOXOOOXX
XXOOOXOOOOOOOOOXOOXX
XOXOOOXOOOOOXOOXOOXX
XOOXOOOXOOOXOXOOOOOO
OOOOXOOOXOXOOXOXOOOX
OOOOOOOXXXOOOOOXOOOX
OOOXXXXXXXXOOOOXOOOX
OXOOOOOXXXOOOOOOOOOX
OOXOOOOOXOOOOOOOOOOX
XOOOOOOOOOOOOOOOOOOO
XOOOXOOOOOOOXOOOOOXX
XOOOOOXOOXOOOOOOOOXX
XOOOOOOOOOOOOOOOOOXX
