20 40
19 21
0 5
0 1
XOOOXOOOXOOOOOXOOOXXOOXOOOOOXOOOOOOOOOOO
XXOOOXOOOXOOOOOXOOXXOXOOOOOXOOOOOOOOOOOO
XOXOOOXOOOOOXOOXOOXXXOOOOOXOOOOOOOOOOOOO
XOOXOOOXOOOXOXOOOOOOOOOOOOOOOOOOOOOOOOOO
OOOOXOOOXOXOOXOXOOOXOOOOOOOOOOOOOOOOOOOO
OOOOOOOXXXOOOOOXOOOXOOOXOOOOOOOOOOOOOOOO
OOOXXOXXXXXOOOOXOOOXXOOOXOOOOOOOOOOOOOOO
OXOOOOOXXXOOOOOOOOOXOXOOOXOOOOOOOOOOOOOO
OOXOOOOOXXOOOOOOOOOXOOXOOOOOOOOOOOOOOOOO
XOOOOOXOOOOOOOOOOOOXOOOXOOOOOOOOOOOOOOOO
XOOOXOOOOOOOXOOOOOXXOXOOXOOOOOOOOOOOOOOO
XOOOOOXOOXOOOOOOOOXXOOXOOOOOOOOOOOOOOOOO
XOOOOOOOOOOOOOOOOOXXOOOOOOOOOOOOOOOOOOOO
XOOOXOOOXOOOOOXOOOXXOOXOOOOOXOOOOOOOOOOO
XXOOOXOOOXOOOOOXOOXXOXOOOOOXOOOOOOOOOOOO
XOXOOOXOOOOOXOOXOOXXXOOOOOXOOOOOOOOOOOOO
XOOXOOOXOOOXOXOOOOOOOOOOOOOOOOOOOOOOOOOO
OOOOXOOOXOXOOXOXOOOXOOOOOOOOOOOOOOOOOOOO
OOOOOOOXXXOOOOOXOOOXOOOXOOOOOOOOOOOOOOOO
OOOXXOXXXXXOOOOXOOOXXOOOXOOOOOOOOOOOOOOO
