20 40
19 21
0 5
0 1
XOOOXOOOXOOOOOXOOOXXOOXOOOOOXOOOOOOOOOOO
XXOOOXOOOXOOOOOXOOXXOXOOOOOXOOOOOOOOOOOO
XOXOOOXOOOOOXOOXOOXXXOOOOOXOOOOOOOOOOOOO
XOOXOOOXOOOXOXOOOOOOOOOOOOOOOOOOOOOOOOOO
OOOOXOOOXOXOOXOXOOOXOOOOOOOOOOOOOOOOOOOO
OOOOOOOXXXOOOOOXOOOXOOOXOOOOOOOOOOOOOOOO
OOOXXOXXXXXOOOOXOOOXXOOOXOOOOOOXOOOOOOOO
OXOOOOOXXXOOOOOOOOOXOXOOOXOOOOXOOOOOOOOO
OOXOOOXOXXOOOOOOOOOXOOXOOOOOOXOOOOOOOOOO
XOOOOOXOOOOOOOOOOOOXOOOXOOOOXOOOOOOOOOOO
XOOOXOOOOOOOXOOOOOXXOXOOXXXXXOOOXOOOOOOO
XOOOOOXOOXOOOOOOOOXXOOXOOOOOOOOOOXOOOOOO
XOOOOOOOOOOOOOOOOOXXOOOOOOOOOOOOOOXOOOOO
XOOOXOOOXOOOOOXOOOXXOOXOOOOOXOOOOOOOOOOO
XXOOOXOOOXOOOOOXOOXXOXOOOOOXOOOOOOOXOOOO
XOXOOOXOOOOOXOOXOOXXXOOOOOXOOOOOOXOOOOOO
XOOXOOOXOOOXOXOOOOOXOOOOOOOOOOOXOOOOOOOO
OOOOXOOOXOXOOXOXOOOXOOOOOOOOOOXOOOOOOOOO
OOOOOOOXXXOOOOOXOOOXOOOXOOOOXOOOOOOOOOOO
OOOXXOXXXXXOOOOXOOOXXOOOXOOOOOOOOOOOOOOO
