25 105
17 0
2 1
21 0
XOOOXOOOXOOOOOXOOOXXOOXOOOOOXOOXOOOOOOOOXXOXOXXOOOOOOOOOOOOOOOOOOOOOOOOOOOOOOOOOOOOOOOOOOOOOOOOOOOOOOOOOO
XXOOOXOOOXOOOOOXOOXXOXOOOOOXOXOOXXOXOOOOXXOOOXXOXOOOOOOOOOOOXXXOOOOOOXXXXXXOOOOOOOOOOOOOXOOOOOXOOOOOOOOOO
XOXOOOXOOOOOXOOXOOXXXOOOOOXOXOOOOOOOXOOOXXOXOXXOXOOOOOOOOOOXXOXXOOOOOXXXXXXOOOOOOOOOOOOXXXOOOXXXOOOOOOOOO
XOOXOOOXOOOXOXOOOOOOOOOOOOOOOOOOOXOOOOOOXXOXOXXOXOOOOOOOOOXXOOOXXOOOOOOXXOOOOOOOOOOOOOOOXOOOOOXOOOOOOOOOO
OOOOXOOOXOXOOXOXOOOXOOOOOOOOOOOOOOXOOXOOXXOXOXXOXOOOOOOOOXXOOOOXXXOOOOOXXOOOOOOOOOOOOOOOOOOXOOOOOOOOOOOOO
OOOOOOOXXXOOOOOXOOOXOOOXOOOOOOOOOOOOOOOOXXOXOXXOXOOOOOOOOXXXXXXXXXOOOOOXXOOOOOOOOOOOOOOOOOOXOOOOOOOOOOOOO
OOOXXOXXXXXOOOOXOOOXXOOOXOOOOOOXOXOXOOOOXXOXOXXOXOOOOOOOXXXOOOOOXXXOOOOXXOOOOOOOOOOOOOOXOOOOOOOOXOOOOOOOO
OXOOOOOXXXOOOOOOOOOXOXOOOXOOOOXOOOXOOOOOXXOXOXXOXOOOOOOOXXOOOOOOOXXOOXXXXXXOOOOOOOOOOOOOXXOOOOXXOOOOOOOOO
OOXOOOXOXXOOOOOOOOOXOOXOOOOOOXOOOOOXOOOOXXOXOXXOXOOOOOOOXOOOOOOOOOXOOXXXXXXOOOOOOOOOOOOOOOXXXXOOOOOOOOOOO
XOOOOOXOOOOOOOOOOOOXOOOXOOOOXOOOOOOOOOOOXOOXOXXOXOOOOOOOOOOOOOOOOOOOOOOOOOOOOOOOOOOOOOOOOOOOOOOOOOOOOOOOO
XOOOXOOOOOOOXOOOOOXXOXOOXXXXXOOOXOOOXOOOXXOXOXXOXXXXXXXXXXXXXXXXXXXXXXXXXXXXXXXXXXXXXXXXXXXXXXXXXXXXXXXXO
XOOOOOXOOXOOOOOOOOXXOOXOOOOOOOOOOXOOOXOOXXOXOOOOXXXXXXXXXXXXXXXXXXXXXXXXXXXXXXXXXXXXOOOOOOOOOOOOOOOOOOOOO
XOOOOOOOOOOOOOOOOOXXOOOOOOOOOOOOOOXOOOOOXXOXOXXOXXXXXXXXXXXXXXXXXXXXXXXXXXXXXXXXXXXXXXXXXXXXXXXXXOXXXXXXX
XOOOXOOOXOOOOOXOOOXXOOXOOOOOXOOOOOOOOOOOOOOXOXXOXOOOOOOXXOOOOOOOOOXOXOOOOOOOOOOOOOOXOOOOOOOXOOOOOOOOOOOOO
XXOOOXOOOXOOOOOXOOXXOXOOOOOXXOXOXOOXOOXOXOOXOXXOXXXOOOOOXXXXOOOOOOOOOXOOOOOOOOOOOOOOOOOOOOXOXOOOOOOOOOOOO
XOXOOOXOOOOOXOOXOOXXXOOOOOXOOOOOOXOOOOOOXXOXOXXOXOOOOOXXXXXXOOOOOOOXOOOOOOOOOOOOOOOOXOOOOXOOOXOOOOOOOOOOO
XOOXOOOXOOOXOXOOOOOXOOOOOOOOOOOXOOOOOOOOXXOXOXXOXXXOOOXXXXXOXOOOOOOXOOXXOOOOOOOOOOXOXOOOXOOOOOXOOOOOOOOOO
OOOOXOOOXOXOOXOXOOOXOOXOXXOOXXXOOOOXOOOOOOOXOXXOXXXOOOOOOOOOOXOOOOXXXOOOOOOOOOOOXXOOOOOXOOOOOOXOOOOOOOOOO
OOOOOOOXXXOOOOOXOOOXOOOXOOOOXOOOOOOOXOOOOOOXOXXOXXOOOOOOOOOOOXOOOOXXOOOOOOOOOOOOOOOXOOXOOOOOOXOXXOOOOOOOO
XXXXXXXXXXXXXXXXXXXXXXXXXXXXXXXXXXXXXXXXXXXXXXXXXXOOOOOOOOOOOOXOOOXXOOOOOOOOOOOOOOOOOXOOOOOOOOOXOOOOOOOOO
XOOOOOOOOOOOOOOOOOOOOOOOOOOOOOOOOOOOOOOOOOOOOOOOOOOOOOOOOOOOOOOXXXXXXOXXXXXXXXXXXXXXOOOOOOOOOOOXOOOOOOOOO
OXOOOOOOOOOOOOOOOOOOOOOOOOOOOOOOOOOOOOOOOOOOOOOOOOOOOOOOOOOOOXXOXXOXOOOOOOOOOOOOOXXXOOOOOOOOOXOOOOOOOOOOO
OOXOOOOOOOOOOOOOOOOOOOOOOOOOOOOOOOOOXXXXOOOOOOOOOOOOOOOOOOOOOOOOOOOXOOOOOOOOOXOOOOXXXOOOOOOOOOXOOOOOOOOOO
OOOXOOOOOOOOOOOOOOOOOOOOOOOXXXXXXXXXOOOOOOOOOOOOOOOOOOOOOOOOOXOOOOOXOOOOOOOOOXOOOOOXXXOOOOOOOOOOOOXOOOOOO
OOOOOOOOOOOOOOXXXXXXXXXXXXXOOOOOOOOOOOOOOOOOOOOOOOOOOOOOOOOOOOXOOOOOOOXXXXXXXXOOOOOOXXXOOOOOOOOOOOOXOOOOO
